....................
....................
....................
....................
....................
....................
....................
....................
....................
....................
....................
#..................#
#..................#
#.......#..........#
####################